{
    "level_1": {
        "size": 2,
        "legend": {
            " ": "default.free",
            "#": "default.brick",
            "-": "default.bridge",
            ". 1": "default.kill_bottom",
            ". 2": "default.kill.bottom"
        },
        "spawn": {
            "player": [ 16, 14, "CENTER", "BOTTOM" ]
        },
        "map": [
            "##############    ##############",
            "##############    ##############",
            "##                            ##",
            "##                            ##",
            "      ####    ####    ####      ",
            "      ####    ####    ####      ",
            "####        ########        ####",
            "####        ########        ####",
            "####    ##            ##    ####",
            "####    ##            ##    ####",
            "              ####              ",
            "              ####              ",
            "##  ######            ######  ##",
            "##  ######            ######  ##",
            "            ########            ",
            "            ########            ",
            "####----################----####",
            "####....################....####"
        ]
    }
}